WWWWWWWWWWWWWWW
WWWWWWMBBBBBBBW
WWWWWWBWBBBBWBW
WWWWWWBWBWWBWBW
WWWWWWBWBWWBWBW
WWWWWWBWBWWBWBW
WWWWWWBWBWWBWBW
WWWWWWBWBBBBWBW
WWWWWWBWWWWWWBW
WWWWWWBBBBBBBBW
WWWWWWBWWWWWWWW
WWWWWWBWWWWWWWW
WWWWWWBWWWWWWWW
WWWWWWGWWWWWWWW
WWWWWWWWWWWWWWW