WWWWWWWWWWWWWWW
WWWWWWMBBBBBBBW
WWWWWWWWWBWBWWW
WWBBBBBBBBWBBBW
WWBWWWBWBWWBWBW
WWBBBWBWBWWBWBW
WWBWWWBWBWWBWBW
WWWWWWBWBBBBWBW
WWWWWWBWWWBWWBW
WWWWWWBBBBWBBBW
WWWWWBBWWWWWWWW
WWWWWBWWWWWWWWW
WWWWWBWWWWWWWWW
WWWWWBGWWWWWWWW
WWWWWWWWWWWWWWW